111111111
100000C01
10P000001
10C000001
100000001
10E000001
100000001
111111111