1111111111111
1P00CCCCC0001
100C000000001
100C000000001
1000CCCCC0001
10000000C0001
10000000C0001
100CCCCC0E001
1111111111111